11111111111111111111111111
100000000000E0000000000001
10000000C000000000C0000001
1000000001000000000P000001
11111111111111111111111111
