1111111111111111111111111
1000010E0100000C001000001
100C01000100000000100C001
111011C001000000001111001
1000011011000000000000001
1C0000000000P011111111111
10000000C0000010000010C01
10111100000000100C0010001
10C0010000000000000011101
10000100000C0000000000001
1111111111111111111111111
