1111111111111111111111111
1000010E0100000C000000001
100C011011000000000000001
100000000000P011111111111
10000100C0000010000000C01
10000100000000000C0000001
1111111111111111111111111
