11111111111111111111111111
100000E00000C000000000P001
11111111111111111111111111
