1111111111111111111111111
1000010E0100000C000000001
100C01101100000000B000001
100000000000P011111111111
10B00000C0000010000000C01
10000100000000000C0000001
1000010000000000000000001
10C001000000C0000B0000001
10000100B0000000000000001
1111111111111111111111111
